1110 1100 0110 1100 0101 0101 0100 0101 0101 0110
1010 1011 1000 0011 1100 0101 0011 1100 0110 1010
1001 0110 1011 1100 0011 1101 0101 0011 1001 0011
1110 1001 0110 1010 1100 0101 0101 0101 0101 0110
1000 0111 1010 1001 0011 1100 0110 1100 0101 0010
1001 0101 0001 0101 0101 0011 1001 0011 1101 0011
