1101 0110 1110 1100 0100 0111 1100 0101 0101 0110
1100 0011 1000 0011 1001 0101 0011 1100 0110 1010
1010 1101 0001 0110 1110 1100 0110 1010 1001 0011
1001 0101 0110 1001 0010 1010 1010 1001 0101 0110
1100 0110 1010 1101 0011 1010 1010 1100 0101 0010
1011 1001 0001 0101 0101 0011 1001 0011 1101 0011
